000000000600000060000000000000
000008000300000030080000000000
000000000300000030000000000000
000031100308080311111111111116
700030900300000300000000000000
770030911422311100000080000000
770030000000300000000000000000
711110080080308000000000008000
770000000000300000000000000000
770000000000300000000000311116
700000000080308000080000300000
000000000000300000000311108000
000000000311422231111100000000
000000080300000030000000000000
000000000300800030080000000000
000000077377077737700000000000
000000777777777777770000000000