000000000000006000000000000000
000080000000003000000000080000
000000000000003000000000000000
622223222222223111111111311116
000003000000003000000000300000
000803000008003008000000308000
000003000000003000000000300000
000002222311113222231111100000
000000000300003000030000000000
000000000308003008030000000000
000000000300003000030000000000
000000000308003008030000000000
000000000300003000030000000000
000000000222223111110000000000
000000000000003000000000000000
000000000000773770000000000000
000000000007777777000000000000