0000000000000000000000000000000
0000000000000000000000000000000
0000000000000000000000000000000
0000022222222222222230000000000
0000090000000000000030000000007
0080090080000000080030000000077
0000090000000000000030000000777
6222290000000000000022222222227
6222230000000000000022222222227
0000030000000000000090000000777
0080030080000000080090000000077
0000030000000000000090000000007
0000022222222222222290000000000
0000000000000000000000000000000
0000000000000000000000000000000
0000000000000000000000000000000
0000000000000000000000000000000
0000000000000000000000000000000