000000000000060000000000000000
622223000000030000000003111116
000003000000030000000803000000
000803080000030000000002230000
000003000000022300000000030000
000003000000000308000008030000
000003000000031100000000030000
000003000008030000000000030000
000003000000030000000000030000
003115230000030000000000030000
034303030000030000000000030000
030223110000030000000000030000
030003000000030000000000030000
022223000000030000000000030000
000003080000030000000000030000
000077700000777000000000777000
000777770007777700000007777700