000000000000060000000000000000
622223000000030000000003111116
000003000000030000000003000000
000003000000030000000002230000
000003000000022300000000030000
000003000000000300000000030000
000003000000031100000000030000
000003000000030000000000030000
000003000000030000000000030000
000003000000030000000000030000
000003000000030000000000030000
000003000000030000000000030000
000003000000030000000000030000
000003000000030000000000030000
000803080000030000000000030000
000077700000737000000000737000
000777770007777700000007777700